
CRW = "countries/Crownland.txt"
ANT = "countries/Anatolia.txt"
WRF = "countries/Western Rev.txt"
THR = "countries/Trakya.txt"
KUR = "countries/Kurdestan.txt"
CLP = "countres/Caliphate.txt"
ADN = "countries/Adana.txt"
CIB = "countries/Enveristan.txt"
ARM = "countries/Armenia.txt"
PLN = "countries/Poland.txt"
TIT = "countries/TurkItaly.txt"
GRE = "countries/Greece.txt"
TUV = "countries/Tuva.txt"
HJZ = "Countries/Hejaz.txt"
AUT = "countries/Austria.txt"
BLG = "countries/Bulgaria.txt"
FIU = "countries/Fiume.txt" 
HNG = "countries/Hungary.txt"
CRT = "countries/Croatia.txt" 
TRN = "countries/Transylvania.txt" 
SLK = "countries/Slovakia.txt" 
CEZ = "countries/Czechia.txt"
ABL = "countries/Albania.txt" 
WAL = "countries/Wallachia.txt" 
MLV = "countries/Moldavia.txt" 
SOR = "countries/Serbia.txt" 
INR = "countries/Iran.txt"
ASY = "countries/Assyria.txt"
SPK = "countries/Spain.txt"
PKR = "countries/Portugal.txt"
FLM = "countries/Flanders.txt" 